------------------------------
-                            -
-                            -
-                            -
-   ---                      -
-                            -
-                   ----     -
-         -----              -
-                            -
-                            -
-    --                      -
-                            -
-                            -
-  -------------             -
-                            -
-                  ----     --
-             --             -
-                            -
-                            -
------------------------------